x111111111111
1111110000000
1111110111111
1111110111111
1100000111111
1101111111001
1101111110111
1101111000011
1001111110011
1111111110011
111111111001v
1111100000111
